11 15
0 0 0 0 0 0 0 0 0 0 0 0 0 0 0
0 9 10 9 8 8 9 9 8 9 8 8 9 2 0
0 9 0 8 0 8 0 8 0 8 0 8 0 9 0 
0 8 9 8 7 8 9 8 8 9 9 8 9 8 0 
0 8 0 9 0 9 0 8 0 9 0 8 0 9 0 
0 9 6 8 8 8 8 8 8 8 9 5 8 8 0 
0 9 0 8 0 8 0 8 0 8 0 8 0 8 0 
0 8 8 8 8 8 7 8 8 8 8 8 8 8 0 
0 9 0 8 0 8 0 8 0 8 0 8 1 9 0
0 4 9 8 8 8 8 9 9 9 9 8 9 3 0
0 0 0 0 0 0 0 0 0 0 0 0 0 0 0



 