11 15
0 0 0 0 0 0 0 0 0 0 0 0 0 0 0
0 9 2 9 9 9 9 9 9 9 9 9 9 9 0
0 9 9 9 9 9 9 6 9 5 9  7 9 9 0
0 9 9 9 9 11 9 9 9 9 9 9 9 9 0
0 9 9 9 9 9 9 9 9 9 10 9 3 9 0
0 9 9 9 9 9 9 9 9 9 9 9 9 9 0
0 9 0 8 0 8 0 8 0 8 10 8 9 8 0
0 9 8 8 8 8 7 8 8 8 9 8 9 8 0
0 9 0 8 0 8 0 8 0 8 9 8 1 9 0
0 4 9 8 8 8 8 9 9 9 9 8 9 9 0
0 0 0 0 0 0 0 0 0 0 0 0 0 0 0